YXML_EEOF	LITERAL1
YXML_EREF	LITERAL1
YXML_ECLOSE	LITERAL1
YXML_ESTACK	LITERAL1
YXML_ESYN	LITERAL1
YXML_OK	LITERAL1
YXML_ELEMSTART	LITERAL1
YXML_CONTENT	LITERAL1
YXML_ELEMEND	LITERAL1
YXML_ATTRSTART	LITERAL1
YXML_ATTRVAL	LITERAL1
YXML_ATTREND	LITERAL1
YXML_PISTART	LITERAL1
YXML_PICONTENT	LITERAL1
YXML_PIEND	LITERAL1

yxml_t	KEYWORD1
yxml_ret_t	KEYWORD1

yxml_init	KEYWORD2
yxml_parse	KEYWORD2
yxml_eof	KEYWORD2

yxml_symlen	KEYWORD2
